...###.....
..##.#.####
.##..###...
.#.........
....@..#...
.##..###...
..#..#....#
.##.##.#.##
.#......##.
.#.....##..
.#######...